37c37
< 3 0x80000104 (0x11166a93) x21 0x0000017e
---
> 3 0x80000104 (0x11166a93) x21 0x0000017f
39c39
< 3 0x8000010c (0x10176b13) x22 0x00000000
---
> 3 0x8000010c (0x10176b13) x22 0x00000101
41c41
< 3 0x80000114 (0x7ff86b93) x23 0x0000002f
---
> 3 0x80000114 (0x7ff86b93) x23 0x000007ff
